['*', '*', '*', '*', '*', '*']
['*', ' ', ' ', ' ', 'o', '*']
['*', ' ', ' ', 'o', ' ', '*']
['*', ' ', ' ', ' ', ' ', '*']
['*', ' ', ' ', ' ', ' ', '*']
['*', '*', '*', '*', '*', '*']
